NO ./textures/Sierpinski.png
SO ./textures/ER.png
WE ./textures/Caitvi_good.png
EA ./textures/Boccher.png

C 255,255,255
F 255,200,200

11111111111111111111
1000W000000000000001
10000000000000000001
10000000000000000001
11111111111111111111
