NO ./textures/Sierpinski.png
SO ./textures/ER.png
WE ./textures/Caitvi_good.png
EA ./textures/Boccher.png

C 255,255,255
F 299,280,128

11111111111111111111
10000000000000000001
100000000N0000000001
10000000000000000001
11111111111111111111
