NO ./textures/signalis/Sierpinski.png
SO ./textures/signalis/LAB.png
WE ./textures/signalis/VORSICHT.png
EA ./textures/signalis/Elevator.png

C 139,143,147
F 48,1,0

11111111111111111111
10000000000S00000001
10000000000000000001
10000000000000000001
11111111111111111111
