NO ./textures/Sierpinski.png
SO ./textures/ER.png
WE ./textures/Caitvi_good.png
EA ./textures/Boccher.png

C 00,00,00
F 000,000,000


11111111111111111111
10000000000S00000001
10000000000000000001
10000000000000000001
11111111111111111111
